3333333333333333333333333333
3dooooooooooo33oooooooooood3
3o3333o33333o33o33333o3333o3
3o3333o33333o33o33333o3333o3
3o3333o33333o33o33333o3333o3
3oooooooooooooooooooooooooo3
3o3333o33o33333333o33o3333o3
3o3333o33o33333333o33o3333o3
3oooooo33oooo33oooo33oooooo3
333333o33333o33o33333o333333
333333o33333o33o33333o333333
333333o33333o33o33333o333333
333333o33oooooooooo33o333333
333333o33o33bbbb33o33o333333
oooooooooo3bbbbbb3oooooooooo
333333o33o33333333o33o333333
333333o33oooooooooo33o333333
333333o33o33333333o33o333333
3oooooooooooo33oooooooooooo3
3o3333o33333o33o33333o3333o3
3o3333o33333o33o33333o3333o3
3ooo33o33333o33o33333o33ooo3
333o33oooooooooooooooo33o333
333o33o33o33333333o33o33o333
3oooooo33oooo33oooo33oooooo3
3o3333333333o33o3333333333o3
3dooooooooooooooooooooooood3
3333333333333333333333333333



